23,23,23,23,23,23,23,23,23,23,23,23,23,23,23,23,23,23,23,23
23,21,23,21,22,23,23,23,22,23,22,21,23,23,23,23,23,21,23,23
23,23,23,23,23,23,21,23,21,23,23,23,23,22,23,23,22,23,23,23
23,23,23,23,23,23,23,22,23,23,23,23,23,23,22,23,23,23,23,23
23,21,23,23,23,23,23,23,22,23,23,23,23,21,23,23,23,23,23,23
23,22,23,21,22,23,23,23,23,23,22,21,23,23,23,23,23,21,22,23
23,23,23,23,23,23,22,23,23,23,23,23,23,22,23,23,23,23,23,23
23,23,23,23,23,21,23,23,23,23,23,23,21,23,23,23,23,23,23,21
23,23,22,23,23,23,23,22,23,22,21,23,23,23,22,23,22,21,23,23
23,21,23,23,23,22,23,23,21,23,23,23,23,23,23,23,23,23,23,21
23,23,23,23,23,23,23,23,23,23,23,22,23,21,23,23,23,23,22,23
23,22,23,23,23,23,22,23,21,23,23,23,23,23,22,23,23,23,23,23
23,21,23,21,22,23,23,23,23,23,21,22,23,23,23,23,23,22,23,23
23,23,22,23,23,23,21,23,23,21,23,23,23,21,23,22,23,23,23,23
23,23,23,23,23,22,23,22,23,23,23,23,23,23,23,23,23,23,23,23