0,0,0,0,0,0,0,0,0,0,0,0,0,0,0,0,0,0,0,0
0,1,1,1,1,1,1,1,1,1,1,1,1,1,1,1,1,1,1,0
9,0,0,0,0,0,0,0,0,0,0,0,0,0,0,0,0,0,0,11
9,0,0,0,0,0,0,0,0,0,0,0,0,0,0,0,0,0,0,12
9,0,0,0,0,0,0,0,0,0,0,0,0,0,0,0,0,0,0,0
9,0,0,0,0,0,0,0,0,0,0,0,0,0,0,0,0,0,0,0
9,0,0,0,0,0,0,0,0,0,0,0,0,0,0,0,0,0,0,0
9,0,0,0,0,0,0,0,0,0,0,0,0,0,0,0,0,0,0,0
9,0,0,0,0,0,0,0,0,0,0,0,0,0,0,0,0,0,0,0
0,0,0,0,0,0,0,0,0,0,0,0,0,0,0,0,0,0,0,17
18,1,1,1,1,1,1,1,4,0,0,0,0,0,0,0,0,0,0,11
9,0,0,0,0,0,0,0,0,0,0,0,0,0,0,0,0,0,0,11
9,0,0,0,0,0,0,0,0,0,0,0,0,0,0,0,0,0,0,11
9,0,0,0,0,0,0,0,0,0,0,0,0,0,0,0,0,0,0,0
10,0,0,0,0,0,0,0,2,1,1,1,1,1,1,1,1,1,1,13